%%%%%%%%%%%%%%
%P           %
%            %
%            %
%            %
%            %
%            %
%      G    G%
%%%%%%%%%%%%%%
% % %%%%%%%%%%
%%%%%%%%%%%%%%
